wwwwwwwwwwwwwwww
wwwwwwwwwwwwwwww
SM.M.M.M.M.M.M.w
S...........cm.w
S..............w
w............m.w
w..............w
w............m.w
w..............w
s............m.w
s............c.w
s.M.M.M.M.M.MmMw
wwwwwwwwwwwwwwww
wwwwwwwwwwwwwwww