wwwwwwwwwwwwwwww
S.............!w
S..............w
S...Mc..Mc..Mc!w
w..mw..mw..mwwww
w.............!w
w..............w
w...Mc..Mc..Mc!w
w..mw..mw..mwwww
w.............!w
w..............w
w...Mc..Mc..Mc!w
w..mw..mw..mwwww
wwwwwwwwwwwwwwww