wwwwwwwwwwwwwwww
wM.............w
wc...M.........w
wcM......M.....w
w.....M....M...w
wWWWWWWWWWWWW..w
S..............s
S..............s
wWWWWWWWWWWWW..w
wcc.....M...M..w
wcc.M.....M....w
wcc....M.......w
wccM...........w
wwwwwwwwwwwwwwww