wwwwwwwwwwwwwwww
w......c.......S
w..............S
w..............S
wm.............w
w.............mw
wm.............w
w.............mw
w..............w
w..............w
s..............w
s..............w
s..............w
wwwwwwwwwwwwwwww